##############
#   #  ####  #
# ####  ##   #
#   #  ##   #
### # ##   #
#         #
###########