##############
#   #  ####   #
# ####  ##   #
#   #  ##   #
### # ##   #
#         #
###########