##############
#   #  ####  #
# ####  ##   #
#   #  ##    #
### # ##     #
#            #
##############